1111111111111111111111111111111
1C001000111000000000011100000C1
10000N0001000000000000100000001
100000000C000010001000C00000001
1000000000000000E000001100000P1
1000110000000010001000000000001
1000000000000000C00000110000001
1C000000000111111111100000000C1
1111111111111111111111111111111
